team,year,overall_wins,overall_losses,home_wins,home_losses,road_wins,road_losses,home_total_attendance,home_avg_attendance,road_avg_attendance,overall_avg_attendance,average_elo
Sacramento Kings,2001,61,21,36,5,25,16,709997.0,17317.0,18438.0,17877.0,1618.9217390243903
Los Angeles Lakers,2001,58,24,34,7,24,17,776336.0,18935.0,19628.0,19281.0,1618.2136804878048
San Antonio Spurs,2001,58,24,32,9,26,15,913175.0,22272.0,16690.0,19481.0,1657.4707256097563
Dallas Mavericks,2001,57,25,30,11,27,14,680138.0,16588.0,15761.0,16175.0,1577.1038804878049
Brooklyn Nets,2001,52,30,33,8,19,22,566077.0,13806.0,16085.0,14946.0,1391.4590658536586
Detroit Pistons,2001,50,32,26,15,24,17,607323.0,14812.0,16397.0,15604.0,1447.7255902439024
Minnesota Timberwolves,2001,50,32,29,12,21,20,717371.0,17496.0,16787.0,17142.0,1549.6740280487804
Boston Celtics,2001,49,33,27,14,22,19,629201.0,15346.0,16436.0,15891.0,1448.9778719512194
Portland Trail Blazers,2001,49,33,30,11,19,22,831385.0,20277.0,17037.0,18657.0,1632.4534329268292
Oklahoma City Thunder,2001,45,37,26,15,19,22,640847.0,15630.0,16497.0,16063.0,1515.7593243902438
New Orleans Pelicans,2001,44,38,21,20,23,18,615424.0,15010.0,16500.0,15755.0,1563.9649402439024
Orlando Magic,2001,44,38,27,14,17,24,605031.0,14756.0,16810.0,15783.0,1512.196531707317
Utah Jazz,2001,44,38,25,16,19,22,792196.0,19321.0,16989.0,18155.0,1610.0879695121953
Philadelphia 76ers,2001,43,39,22,19,21,20,805692.0,19651.0,18582.0,19116.0,1618.3245365853659
Indiana Pacers,2001,42,40,25,16,17,24,733444.0,17888.0,16508.0,17198.0,1520.23355
Toronto Raptors,2001,42,40,24,17,18,23,793256.0,19347.0,17611.0,18479.0,1522.7771451219512
Milwaukee Bucks,2001,41,41,25,16,16,25,683125.0,16661.0,16584.0,16623.0,1553.0888939024392
Los Angeles Clippers,2001,39,43,25,16,14,27,599448.0,14620.0,15823.0,15222.0,1358.1049804878048
Washington Wizards,2001,37,45,22,19,15,26,638653.0,15576.0,15872.0,15724.0,1349.9587475609756
Miami Heat,2001,36,46,18,23,18,23,677186.0,16516.0,17046.0,16781.0,1571.6694121951218
Phoenix Suns,2001,36,46,23,18,13,28,737586.0,17989.0,17157.0,17573.0,1581.0164231707317
Atlanta Hawks,2001,33,49,23,18,10,31,560324.0,13666.0,16403.0,15035.0,1355.307580487805
New York Knicks,2001,30,52,19,22,11,30,810283.0,19763.0,17680.0,18721.0,1543.1086829268293
Cleveland Cavaliers,2001,29,53,20,21,9,32,650775.0,15872.0,16064.0,15968.0,1415.925218292683
Houston Rockets,2001,28,54,18,23,10,31,518555.0,12647.0,16714.0,14680.0,1541.56015
Denver Nuggets,2001,27,55,20,21,7,34,619300.0,15104.0,16403.0,15754.0,1468.6875390243904
Memphis Grizzlies,2001,23,59,15,26,8,33,563218.0,13737.0,15822.0,14779.0,1376.9194
Chicago Bulls,2001,21,61,14,27,7,34,888654.0,21674.0,16336.0,19005.0,1262.6468743902437
Golden State Warriors,2001,21,61,14,27,7,34,591981.0,14438.0,16058.0,15248.0,1326.936695121951
Dallas Mavericks,2002,60,22,33,8,27,14,802783.0,19580.0,17049.0,18314.0,1611.9967682926826
San Antonio Spurs,2002,60,22,33,8,27,14,906390.0,22107.0,17248.0,19677.0,1653.3660243902439
Sacramento Kings,2002,59,23,35,6,24,17,709997.0,17317.0,17701.0,17509.0,1658.2344865853659
Minnesota Timberwolves,2002,51,31,33,8,18,23,731673.0,17845.0,16961.0,17403.0,1593.1114865853658
Detroit Pistons,2002,50,32,30,11,20,21,760807.0,18556.0,16417.0,17486.0,1514.7880402439025
Los Angeles Lakers,2002,50,32,31,10,19,22,778877.0,18997.0,20102.0,19549.0,1690.5573182926828
Portland Trail Blazers,2002,50,32,27,14,23,18,797821.0,19459.0,16483.0,17971.0,1563.349430487805
Brooklyn Nets,2002,49,33,33,8,16,25,564194.0,13760.0,16403.0,15082.0,1522.5428780487805
Indiana Pacers,2002,48,34,32,9,16,25,686537.0,16744.0,16677.0,16711.0,1495.1340987804879
Philadelphia 76ers,2002,48,34,25,16,23,18,842976.0,20560.0,18720.0,19640.0,1543.7280951219514
New Orleans Pelicans,2002,47,35,29,12,18,23,462738.0,11286.0,16457.0,13871.0,1525.7318097560976
Utah Jazz,2002,47,35,29,12,18,23,766108.0,18685.0,16667.0,17676.0,1554.571912195122
Boston Celtics,2002,44,38,25,16,19,22,659751.0,16091.0,17576.0,16833.0,1517.5011463414635
Phoenix Suns,2002,44,38,30,11,14,27,668939.0,16315.0,16765.0,16540.0,1521.1678548780487
Houston Rockets,2002,43,39,28,13,15,26,481227.0,11737.0,16551.0,14144.0,1456.771524390244
Milwaukee Bucks,2002,42,40,25,16,17,24,745305.0,18178.0,17043.0,17610.0,1549.5378109756098
Orlando Magic,2002,42,40,26,15,16,25,621121.0,15149.0,17345.0,16247.0,1526.234893902439
Oklahoma City Thunder,2002,40,42,25,16,15,26,633516.0,15451.0,16013.0,15732.0,1566.7233158536585
Golden State Warriors,2002,38,44,24,17,14,27,593182.0,14467.0,16202.0,15335.0,1331.5438036585365
New York Knicks,2002,37,45,24,17,13,28,810283.0,19763.0,17082.0,18422.0,1432.802154878049
Washington Wizards,2002,37,45,23,18,14,27,847634.0,20674.0,19939.0,20306.0,1426.1780268292684
Atlanta Hawks,2002,35,47,26,15,9,32,506110.0,12344.0,16315.0,14329.0,1388.1355097560975
Chicago Bulls,2002,30,52,27,14,3,38,776311.0,18934.0,16000.0,17467.0,1292.6427780487804
Memphis Grizzlies,2002,28,54,20,21,8,33,591030.0,14415.0,15841.0,15128.0,1342.8254585365855
Los Angeles Clippers,2002,27,55,16,25,11,30,740185.0,18053.0,16569.0,17311.0,1498.5698609756098
Miami Heat,2002,25,57,16,25,9,32,655549.0,15989.0,16702.0,16345.0,1452.4142707317073
Toronto Raptors,2002,24,58,15,26,9,32,811135.0,19783.0,17200.0,18492.0,1521.2749353658537
Cleveland Cavaliers,2002,17,65,14,27,3,38,596115.0,14539.0,15809.0,15174.0,1388.2052146341464
Denver Nuggets,2002,17,65,13,28,4,37,633846.0,15459.0,16396.0,15928.0,1412.6297987804878
Indiana Pacers,2003,61,21,34,7,27,14,670461.0,16352.0,16856.0,16604.0,1555.0424658536585
Minnesota Timberwolves,2003,58,24,31,10,27,14,643684.0,15699.0,16657.0,16178.0,1559.8225658536585
San Antonio Spurs,2003,57,25,33,8,24,17,735970.0,17950.0,16559.0,17255.0,1646.3458280487805
Los Angeles Lakers,2003,56,26,34,7,22,19,777888.0,18972.0,19107.0,19040.0,1593.3412841463414
Sacramento Kings,2003,55,27,34,7,21,20,709997.0,17317.0,17924.0,17620.0,1663.2654524390243
Detroit Pistons,2003,54,28,31,10,23,18,839278.0,20470.0,16053.0,18261.0,1589.701207317073
Dallas Mavericks,2003,52,30,36,5,16,25,816429.0,19912.0,17618.0,18765.0,1694.3561536585366
Memphis Grizzlies,2003,50,32,31,10,19,22,611322.0,14910.0,16277.0,15593.0,1386.7209024390245
Brooklyn Nets,2003,47,35,28,13,19,22,622574.0,15184.0,16956.0,16070.0,1597.8479963414636
Houston Rockets,2003,45,37,27,14,18,23,565166.0,13784.0,17919.0,15851.0,1501.5162926829269
Denver Nuggets,2003,43,39,29,12,14,27,607813.0,14824.0,16299.0,15562.0,1336.3920756097561
Miami Heat,2003,42,40,29,12,13,28,628242.0,15322.0,15844.0,15583.0,1418.229819512195
Utah Jazz,2003,42,40,28,13,14,27,786034.0,19171.0,16585.0,17878.0,1559.3945890243901
Milwaukee Bucks,2003,41,41,27,14,14,27,665966.0,16243.0,16327.0,16285.0,1480.3406951219513
New Orleans Pelicans,2003,41,41,25,16,16,25,641683.0,15650.0,16481.0,16066.0,1541.4096963414636
Portland Trail Blazers,2003,41,41,25,16,16,25,796250.0,19420.0,16458.0,17939.0,1587.5946597560976
New York Knicks,2003,39,43,23,18,16,25,779479.0,19011.0,17104.0,18058.0,1442.3498670731708
Golden State Warriors,2003,37,45,27,14,10,31,634935.0,15486.0,16297.0,15891.0,1439.0334817073172
Oklahoma City Thunder,2003,37,45,21,20,16,25,637194.0,15541.0,16243.0,15892.0,1510.8633341463415
Boston Celtics,2003,36,46,19,22,17,24,709049.0,17293.0,17263.0,17278.0,1525.3838658536586
Cleveland Cavaliers,2003,35,47,23,18,12,29,471374.0,11496.0,16087.0,13792.0,1316.7494585365853
Philadelphia 76ers,2003,33,49,21,20,12,29,807097.0,19685.0,18408.0,19046.0,1545.85325
Toronto Raptors,2003,33,49,18,23,15,26,777507.0,18963.0,16509.0,17736.0,1396.0576670731707
Phoenix Suns,2003,29,53,18,23,11,30,666559.0,16257.0,16318.0,16288.0,1520.9743512195123
Atlanta Hawks,2003,28,54,18,23,10,31,528655.0,12894.0,16294.0,14594.0,1423.2803256097561
Los Angeles Clippers,2003,28,54,18,23,10,31,706471.0,17231.0,16276.0,16753.0,1425.5222134146343
Washington Wizards,2003,25,57,17,24,8,33,827092.0,20172.0,19311.0,19742.0,1472.8024195121952
Chicago Bulls,2003,23,59,14,27,9,32,804303.0,19617.0,16268.0,17942.0,1364.2428914634147
Orlando Magic,2003,21,61,11,30,10,31,605901.0,14778.0,17305.0,16041.0,1496.4822524390245
Phoenix Suns,2004,62,20,31,10,31,10,670385.0,16350.0,16461.0,16406.0,1449.0643524390243
Miami Heat,2004,59,23,35,6,24,17,624809.0,15239.0,16524.0,15881.0,1439.815824390244
San Antonio Spurs,2004,59,23,38,3,21,20,739706.0,18041.0,17347.0,17694.0,1682.2878548780488
Dallas Mavericks,2004,58,24,29,12,29,12,825594.0,20136.0,17452.0,18794.0,1616.368186585366
Detroit Pistons,2004,54,28,32,9,22,19,872902.0,21290.0,17127.0,19209.0,1596.6079256097562
Oklahoma City Thunder,2004,52,30,26,15,26,15,625474.0,15255.0,16842.0,16049.0,1492.8221646341462
Houston Rockets,2004,51,31,26,15,25,16,640794.0,15629.0,17768.0,16698.0,1566.802231707317
Sacramento Kings,2004,50,32,30,11,20,21,709997.0,17317.0,17813.0,17565.0,1653.6094353658536
Denver Nuggets,2004,49,33,31,10,18,23,721476.0,17596.0,17184.0,17390.0,1478.6649475609756
Chicago Bulls,2004,47,35,27,14,20,21,809177.0,19736.0,16517.0,18126.0,1354.4729195121952
Boston Celtics,2004,45,37,27,14,18,23,664248.0,16201.0,16955.0,16578.0,1458.7571975609758
Memphis Grizzlies,2004,45,37,26,15,19,22,622723.0,15188.0,16695.0,15941.0,1540.3977841463416
Washington Wizards,2004,45,37,29,12,16,25,645363.0,15740.0,16008.0,15874.0,1381.457469512195
Indiana Pacers,2004,44,38,25,16,19,22,678326.0,16544.0,17710.0,17127.0,1601.94091097561
Minnesota Timberwolves,2004,44,38,24,17,20,21,723071.0,17635.0,17862.0,17749.0,1625.8815195121954
Philadelphia 76ers,2004,43,39,25,16,18,23,788128.0,19222.0,17672.0,18447.0,1475.3504109756097
Brooklyn Nets,2004,42,40,24,17,18,23,613051.0,14952.0,17358.0,16155.0,1579.259825609756
Cleveland Cavaliers,2004,42,40,29,12,13,28,749790.0,18287.0,18755.0,18521.0,1384.7094926829268
Los Angeles Clippers,2004,37,45,27,14,10,31,665396.0,16229.0,16258.0,16243.0,1428.5291170731707
Orlando Magic,2004,36,46,24,17,12,29,589144.0,14369.0,16793.0,15581.0,1373.41915
Golden State Warriors,2004,34,48,20,21,14,27,665648.0,16235.0,15885.0,16060.0,1474.607625609756
Los Angeles Lakers,2004,34,48,22,19,12,29,777757.0,18969.0,19380.0,19175.0,1621.0469121951219
New York Knicks,2004,33,49,22,19,11,30,785739.0,19164.0,17589.0,18376.0,1460.6157207317074
Toronto Raptors,2004,33,49,22,19,11,30,750608.0,18307.0,16480.0,17394.0,1404.1303048780487
Milwaukee Bucks,2004,30,52,23,18,7,34,690180.0,16833.0,16213.0,16523.0,1514.5975085365853
Portland Trail Blazers,2004,27,55,18,23,9,32,684038.0,16683.0,16282.0,16483.0,1517.672836585366
Utah Jazz,2004,26,56,18,23,8,33,785330.0,19154.0,16537.0,17845.0,1497.399937804878
New Orleans Pelicans,2004,18,64,11,30,7,34,587613.0,14332.0,16679.0,15505.0,1517.097667073171
Atlanta Hawks,2004,13,69,9,32,4,37,565728.0,13798.0,16282.0,15040.0,1400.8164207317075
Detroit Pistons,2005,64,18,37,4,27,14,905116.0,22076.0,17868.0,19972.0,1603.1165634146341
San Antonio Spurs,2005,63,19,34,7,29,12,750970.0,18316.0,17419.0,17868.0,1719.231101219512
Dallas Mavericks,2005,60,22,34,7,26,15,822533.0,20061.0,17259.0,18660.0,1623.0534012195124
Phoenix Suns,2005,54,28,31,10,23,18,726066.0,17708.0,17570.0,17639.0,1626.5994975609756
Miami Heat,2005,52,30,31,10,21,20,815143.0,19881.0,18891.0,19386.0,1625.7742012195122
Cleveland Cavaliers,2005,50,32,31,10,19,22,784249.0,19128.0,18275.0,18701.0,1492.1224146341463
Memphis Grizzlies,2005,49,33,30,11,19,22,691362.0,16862.0,16621.0,16742.0,1560.8149402439024
Brooklyn Nets,2005,49,33,29,12,20,21,618681.0,15089.0,16624.0,15857.0,1451.1908695121951
Los Angeles Clippers,2005,47,35,27,14,20,21,696181.0,16980.0,16735.0,16857.0,1460.3311097560975
Los Angeles Lakers,2005,45,37,27,14,18,23,770494.0,18792.0,18810.0,18801.0,1521.765263414634
Denver Nuggets,2005,44,38,26,15,18,23,723949.0,17657.0,17506.0,17582.0,1520.4959024390243
Sacramento Kings,2005,44,38,27,14,17,24,709997.0,17317.0,17702.0,17509.0,1587.7856292682927
Washington Wizards,2005,42,40,27,14,15,26,705069.0,17196.0,16862.0,17029.0,1469.1458170731707
Chicago Bulls,2005,41,41,21,20,20,21,828384.0,20204.0,17334.0,18769.0,1457.457224390244
Indiana Pacers,2005,41,41,27,14,14,27,696764.0,16994.0,16895.0,16944.0,1543.069574390244
Utah Jazz,2005,41,41,22,19,19,22,769014.0,18756.0,16923.0,17839.0,1435.8578146341465
Milwaukee Bucks,2005,40,42,25,16,15,26,637009.0,15536.0,16651.0,16094.0,1440.8331012195122
New Orleans Pelicans,2005,38,44,24,17,14,27,583070.0,14221.0,16690.0,15456.0,1372.6318743902439
Philadelphia 76ers,2005,38,44,23,18,15,26,732686.0,17870.0,17933.0,17902.0,1454.1819414634147
Orlando Magic,2005,36,46,26,15,10,31,597942.0,14583.0,17510.0,16047.0,1420.9937268292683
Oklahoma City Thunder,2005,35,47,22,19,13,28,675490.0,16475.0,17029.0,16752.0,1583.504945121951
Golden State Warriors,2005,34,48,21,20,13,28,670368.0,16350.0,16708.0,16529.0,1428.4577853658536
Houston Rockets,2005,34,48,15,26,19,22,663444.0,16181.0,18183.0,17182.0,1560.2454536585367
Boston Celtics,2005,33,49,21,20,12,29,656081.0,16001.0,17216.0,16609.0,1495.785593902439
Minnesota Timberwolves,2005,33,49,24,17,9,32,704438.0,17181.0,17874.0,17527.0,1556.031219512195
Toronto Raptors,2005,27,55,15,26,12,29,703388.0,17155.0,16677.0,16916.0,1428.540598780488
Atlanta Hawks,2005,26,56,18,23,8,33,586390.0,14302.0,16730.0,15516.0,1302.470062195122
Charlotte Hornets,2005,26,56,17,24,9,32,591701.0,14431.0,16717.0,15574.0,1278.0913463414633
New York Knicks,2005,23,59,15,26,8,33,800144.0,19515.0,17540.0,18528.0,1427.1802097560976
Portland Trail Blazers,2005,21,61,15,26,6,35,680374.0,16594.0,16658.0,16626.0,1448.2701390243903
Dallas Mavericks,2006,67,15,36,5,31,10,824693.0,20114.0,17591.0,18853.0,1670.5285707317075
Phoenix Suns,2006,61,21,33,8,28,13,730179.0,17809.0,17694.0,17751.0,1646.1250317073172
San Antonio Spurs,2006,58,24,31,10,27,14,770677.0,18797.0,18376.0,18586.0,1683.4544085365853
Detroit Pistons,2006,53,29,26,15,27,14,905116.0,22076.0,18637.0,20356.0,1701.013125609756
Houston Rockets,2006,52,30,28,13,24,17,636110.0,15514.0,17554.0,16534.0,1511.1037158536585
Utah Jazz,2006,51,31,31,10,20,21,751621.0,18332.0,17048.0,17690.0,1436.4769719512194
Cleveland Cavaliers,2006,50,32,30,11,20,21,792391.0,19326.0,18800.0,19063.0,1531.105193902439
Chicago Bulls,2006,49,33,31,10,18,23,868720.0,21188.0,17397.0,19292.0,1498.2483573170732
Toronto Raptors,2006,47,35,30,11,17,24,699332.0,17056.0,16595.0,16826.0,1406.3006365853657
Denver Nuggets,2006,45,37,23,18,22,19,702645.0,17137.0,17637.0,17387.0,1535.4317512195123
Miami Heat,2006,44,38,27,14,17,24,818149.0,19954.0,18991.0,19473.0,1616.7331182926828
Golden State Warriors,2006,42,40,30,11,12,29,749185.0,18272.0,16775.0,17524.0,1478.9400036585366
Los Angeles Lakers,2006,42,40,25,16,17,24,774189.0,18882.0,18812.0,18847.0,1514.9794365853659
Brooklyn Nets,2006,41,41,24,17,17,24,691543.0,16866.0,17710.0,17288.0,1535.5599707317074
Washington Wizards,2006,41,41,26,15,15,26,705062.0,17196.0,17291.0,17244.0,1498.9371963414633
Orlando Magic,2006,40,42,25,16,15,26,638005.0,15561.0,17084.0,16322.0,1412.3433963414634
Los Angeles Clippers,2006,40,42,25,16,15,26,712409.0,17375.0,16944.0,17160.0,1529.5475024390244
New Orleans Pelicans,2006,39,43,24,17,15,26,744920.0,18168.0,16659.0,17414.0,1443.967437804878
Indiana Pacers,2006,35,47,22,19,13,28,663368.0,16179.0,17624.0,16902.0,1528.8704731707319
Philadelphia 76ers,2006,35,47,21,20,14,27,677278.0,16518.0,18627.0,17573.0,1466.710662195122
Charlotte Hornets,2006,33,49,20,21,13,28,671011.0,16366.0,17117.0,16741.0,1354.564092682927
New York Knicks,2006,33,49,19,22,14,27,776176.0,18931.0,17572.0,18251.0,1362.657007317073
Sacramento Kings,2006,33,49,20,21,13,28,709997.0,17317.0,17101.0,17209.0,1514.1866499999999
Minnesota Timberwolves,2006,32,50,20,21,12,29,662167.0,16150.0,17421.0,16785.0,1493.8701414634145
Portland Trail Blazers,2006,32,50,18,23,14,27,617019.0,15049.0,17144.0,16097.0,1351.8621341463415
Oklahoma City Thunder,2006,31,51,20,21,11,30,664157.0,16198.0,17195.0,16697.0,1458.0431914634146
Atlanta Hawks,2006,30,52,18,23,12,29,617942.0,15071.0,17067.0,16069.0,1309.4960048780488
Milwaukee Bucks,2006,28,54,18,23,10,31,681337.0,16617.0,17119.0,16868.0,1443.1598841463415
Boston Celtics,2006,24,58,12,29,12,29,692873.0,16899.0,17920.0,17409.0,1471.0040682926829
Memphis Grizzlies,2006,22,60,14,27,8,33,647533.0,15793.0,17211.0,16502.0,1558.848868292683
Boston Celtics,2007,66,16,35,6,31,10,690576.0,16843.0,17570.0,17206.0,1389.8860085365855
Detroit Pistons,2007,59,23,34,7,25,16,905116.0,22076.0,18001.0,20038.0,1606.2855463414635
Los Angeles Lakers,2007,57,25,30,11,27,14,778415.0,18985.0,18917.0,18951.0,1536.4421902439026
New Orleans Pelicans,2007,56,26,30,11,26,15,731165.0,17833.0,16981.0,17407.0,1451.9541341463414
San Antonio Spurs,2007,56,26,34,7,22,19,764823.0,18654.0,17464.0,18059.0,1676.9656170731707
Houston Rockets,2007,55,27,31,10,24,17,678362.0,16545.0,18187.0,17366.0,1578.5224646341462
Phoenix Suns,2007,55,27,30,11,25,16,755302.0,18422.0,18541.0,18481.0,1654.4460036585365
Utah Jazz,2007,54,28,37,4,17,24,802214.0,19566.0,17501.0,18533.0,1568.827480487805
Orlando Magic,2007,52,30,25,16,27,14,700887.0,17094.0,17470.0,17282.0,1494.7826841463414
Dallas Mavericks,2007,51,31,34,7,17,24,834411.0,20351.0,17821.0,19086.0,1696.3920804878048
Denver Nuggets,2007,50,32,33,8,17,24,706437.0,17230.0,18163.0,17696.0,1511.1707304878048
Golden State Warriors,2007,48,34,27,14,21,20,742267.0,18104.0,17012.0,17558.0,1474.5587475609755
Cleveland Cavaliers,2007,45,37,27,14,18,23,837883.0,20436.0,18940.0,19688.0,1556.8451329268294
Washington Wizards,2007,43,39,25,16,18,23,753283.0,18372.0,17270.0,17821.0,1523.029274390244
Toronto Raptors,2007,41,41,25,16,16,25,748603.0,18258.0,17347.0,17802.0,1478.0529
Portland Trail Blazers,2007,41,41,28,13,13,28,670778.0,16360.0,17558.0,16959.0,1384.5836195121951
Philadelphia 76ers,2007,40,42,22,19,18,23,608603.0,14843.0,17849.0,16346.0,1425.3158158536587
Sacramento Kings,2007,38,44,26,15,12,29,709997.0,17317.0,17282.0,17299.0,1491.7851731707317
Atlanta Hawks,2007,37,45,25,16,12,29,639375.0,15594.0,17170.0,16382.0,1388.6821743902437
Indiana Pacers,2007,36,46,21,20,15,26,629750.0,15359.0,17802.0,16581.0,1464.2923475609757
Brooklyn Nets,2007,34,48,21,20,13,28,693955.0,16925.0,17870.0,17398.0,1483.746993902439
Chicago Bulls,2007,33,49,20,21,13,28,912364.0,22252.0,18153.0,20202.0,1568.0125719512196
Charlotte Hornets,2007,32,50,21,20,11,30,637520.0,15549.0,17477.0,16513.0,1403.588343902439
Milwaukee Bucks,2007,26,56,19,22,7,34,663629.0,16186.0,17350.0,16768.0,1432.917630487805
Los Angeles Clippers,2007,23,59,13,28,10,31,755261.0,18421.0,17406.0,17913.0,1513.3890780487804
New York Knicks,2007,23,59,15,26,8,33,771017.0,18805.0,17984.0,18394.0,1412.1408743902439
Memphis Grizzlies,2007,22,60,14,27,8,33,600836.0,14654.0,17336.0,15995.0,1418.1789
Minnesota Timberwolves,2007,22,60,15,26,7,34,655947.0,15998.0,17894.0,16946.0,1445.9526609756097
Oklahoma City Thunder,2007,20,62,13,28,7,34,654163.0,15955.0,17445.0,16700.0,1456.089042682927
Miami Heat,2007,15,67,9,32,6,35,808541.0,19720.0,18945.0,19332.0,1518.176656097561
Cleveland Cavaliers,2008,66,16,39,2,27,14,839074.0,20465.0,17992.0,19228.0,1531.0315865853659
Los Angeles Lakers,2008,65,17,36,5,29,12,778877.0,18997.0,18671.0,18834.0,1615.108131707317
Boston Celtics,2008,62,20,35,6,27,14,763584.0,18624.0,19042.0,18833.0,1632.4472073170732
Orlando Magic,2008,59,23,32,9,27,14,709346.0,17301.0,17540.0,17420.0,1567.5971048780489
Denver Nuggets,2008,54,28,33,8,21,20,711962.0,17364.0,18115.0,17740.0,1574.4532207317072
Portland Trail Blazers,2008,54,28,34,7,20,21,801566.0,19550.0,16700.0,18125.0,1478.443975609756
San Antonio Spurs,2008,54,28,28,13,26,15,761149.0,18564.0,17954.0,18259.0,1653.1445926829267
Houston Rockets,2008,53,29,33,8,20,21,718524.0,17524.0,17527.0,17526.0,1602.6142573170732
Dallas Mavericks,2008,50,32,32,9,18,23,831738.0,20286.0,17716.0,19001.0,1619.5081536585367
New Orleans Pelicans,2008,49,33,28,13,21,20,581432.0,14181.0,16905.0,15543.0,1586.1719402439026
Utah Jazz,2008,48,34,33,8,15,26,816211.0,19907.0,17215.0,18561.0,1616.797125609756
Atlanta Hawks,2008,47,35,31,10,16,25,667518.0,16280.0,16853.0,16567.0,1435.7425353658537
Phoenix Suns,2008,46,36,28,13,18,23,755302.0,18422.0,18046.0,18234.0,1636.0180463414633
Miami Heat,2008,43,39,28,13,15,26,798004.0,19463.0,17503.0,18483.0,1343.7764634146342
Chicago Bulls,2008,41,41,28,13,13,28,901502.0,21987.0,17353.0,19670.0,1480.9398317073171
Philadelphia 76ers,2008,41,41,24,17,17,24,609675.0,14870.0,17231.0,16050.0,1480.6452073170733
Detroit Pistons,2008,39,43,21,20,18,23,905116.0,22076.0,17714.0,19895.0,1650.4378573170732
Indiana Pacers,2008,36,46,25,16,11,30,501092.0,12221.0,17217.0,14719.0,1437.0906670731706
Charlotte Hornets,2008,35,47,23,18,12,29,603403.0,14717.0,17294.0,16005.0,1418.0348524390245
Milwaukee Bucks,2008,34,48,22,19,12,29,639421.0,15595.0,16738.0,16167.0,1367.535362195122
Brooklyn Nets,2008,34,48,19,22,15,26,641921.0,15656.0,17610.0,16633.0,1433.7874987804878
Toronto Raptors,2008,33,49,18,23,15,26,796835.0,19435.0,16653.0,18044.0,1541.2813463414634
New York Knicks,2008,32,50,20,21,12,29,783739.0,19115.0,17429.0,18272.0,1359.4456280487805
Golden State Warriors,2008,29,53,21,20,8,33,804864.0,19630.0,17255.0,18443.0,1585.928845121951
Memphis Grizzlies,2008,24,58,16,25,8,33,523578.0,12770.0,16985.0,14877.0,1369.26685
Minnesota Timberwolves,2008,24,58,11,30,13,28,593537.0,14476.0,16801.0,15639.0,1330.205313414634
Oklahoma City Thunder,2008,23,59,15,26,8,33,547556.0,13355.0,17158.0,15257.0,1349.8675719512196
Los Angeles Clippers,2008,19,63,11,30,8,33,692408.0,16888.0,16628.0,16758.0,1417.5492975609757
Washington Wizards,2008,19,63,13,28,6,35,736461.0,17962.0,16774.0,17368.0,1477.1784707317074
Sacramento Kings,2008,17,65,11,30,6,35,580181.0,14150.0,17209.0,15680.0,1452.7099207317074
Cleveland Cavaliers,2009,61,21,35,6,26,15,820439.0,20010.0,18899.0,19455.0,1675.6396695121953
Orlando Magic,2009,59,23,34,7,25,16,698768.0,17043.0,17900.0,17466.0,1645.606875609756
Los Angeles Lakers,2009,57,25,34,7,23,18,778877.0,18997.0,19268.0,19130.0,1713.8247146341462
Dallas Mavericks,2009,55,27,28,13,27,14,821723.0,20042.0,17102.0,18572.0,1566.076974390244
Phoenix Suns,2009,54,28,32,9,22,19,755302.0,18422.0,18122.0,18272.0,1560.1160097560976
Atlanta Hawks,2009,53,29,34,7,19,22,686688.0,16748.0,17303.0,17025.0,1523.2073
Denver Nuggets,2009,53,29,34,7,19,22,706165.0,17223.0,17227.0,17225.0,1594.3738743902438
Utah Jazz,2009,53,29,32,9,21,20,816042.0,19903.0,17038.0,18470.0,1591.0457426829269
Boston Celtics,2009,50,32,24,17,26,15,763584.0,18624.0,18975.0,18799.0,1705.4086707317074
Oklahoma City Thunder,2009,50,32,27,14,23,18,747732.0,18693.0,16679.0,17674.0,1317.0346097560976
Portland Trail Blazers,2009,50,32,26,15,24,17,841499.0,20524.0,17167.0,18866.0,1564.4557048780487
San Antonio Spurs,2009,50,32,29,12,21,20,749048.0,18269.0,17626.0,17951.0,1616.2539329268293
Miami Heat,2009,47,35,24,17,23,18,729178.0,18229.0,18150.0,18189.0,1447.408443902439
Milwaukee Bucks,2009,46,36,28,13,18,23,630976.0,15389.0,16947.0,16168.0,1423.4101219512195
Charlotte Hornets,2009,44,38,31,10,13,28,581049.0,14526.0,17310.0,15935.0,1448.5948378048781
Houston Rockets,2009,42,40,23,18,19,22,699280.0,17482.0,17589.0,17536.0,1608.941673170732
Chicago Bulls,2009,41,41,24,17,17,24,847903.0,21197.0,17558.0,19355.0,1469.8031280487803
Memphis Grizzlies,2009,40,42,23,18,17,24,509806.0,12745.0,17101.0,14949.0,1332.2448475609756
Toronto Raptors,2009,40,42,25,16,15,26,769707.0,18773.0,16785.0,17779.0,1456.4579207317072
New Orleans Pelicans,2009,37,45,24,17,13,28,695727.0,16968.0,17702.0,17331.0,1596.1396463414635
Indiana Pacers,2009,32,50,23,18,9,32,581472.0,14182.0,16628.0,15405.0,1464.1336914634146
Los Angeles Clippers,2009,29,53,21,20,8,33,646830.0,16170.0,17202.0,16692.0,1327.4370670731707
New York Knicks,2009,29,53,18,23,11,30,790801.0,19287.0,17729.0,18518.0,1402.112825609756
Detroit Pistons,2009,27,55,17,24,10,31,896971.0,21877.0,18024.0,19950.0,1535.6990548780486
Philadelphia 76ers,2009,27,55,12,29,15,26,647898.0,15802.0,17358.0,16570.0,1503.646674390244
Golden State Warriors,2009,26,56,18,23,8,33,776660.0,18942.0,16942.0,17942.0,1453.1146048780488
Washington Wizards,2009,26,56,15,26,11,30,681117.0,16612.0,17157.0,16884.0,1363.8564634146342
Sacramento Kings,2009,25,57,18,23,7,34,502852.0,12571.0,17227.0,14928.0,1350.9132536585364
Minnesota Timberwolves,2009,15,67,10,31,5,36,594743.0,14505.0,16845.0,15661.0,1368.5171158536587
Brooklyn Nets,2009,12,70,8,33,4,37,621062.0,15147.0,17586.0,16367.0,1441.9726817073172
Chicago Bulls,2010,62,20,36,5,26,15,849760.0,20725.0,17735.0,19230.0,1483.8902841463414
San Antonio Spurs,2010,61,21,36,5,25,16,741676.0,18089.0,17707.0,17898.0,1594.3022829268293
Miami Heat,2010,58,24,30,11,28,13,726935.0,17730.0,18040.0,17885.0,1524.1650939024391
Dallas Mavericks,2010,57,25,29,12,28,13,819770.0,19994.0,17129.0,18561.0,1602.0917548780487
Los Angeles Lakers,2010,57,25,30,11,27,14,778877.0,18997.0,19265.0,19131.0,1691.54406097561
Boston Celtics,2010,56,26,33,8,23,18,744961.0,18169.0,18154.0,18161.0,1618.2238439024388
Oklahoma City Thunder,2010,55,27,30,11,25,16,738149.0,18003.0,16876.0,17440.0,1529.4793512195122
Orlando Magic,2010,52,30,29,12,23,18,715901.0,17461.0,17838.0,17649.0,1648.6435268292685
Denver Nuggets,2010,50,32,33,8,17,24,737812.0,17995.0,17446.0,17720.0,1628.023987804878
Portland Trail Blazers,2010,48,34,30,11,18,23,840411.0,20497.0,16546.0,18521.0,1578.848880487805
Memphis Grizzlies,2010,46,36,30,11,16,25,552914.0,13485.0,16691.0,15088.0,1469.0211853658536
New Orleans Pelicans,2010,46,36,28,13,18,23,620366.0,15130.0,17168.0,16149.0,1470.5429780487805
Atlanta Hawks,2010,44,38,24,17,20,21,678375.0,16545.0,17097.0,16821.0,1583.0742524390246
Houston Rockets,2010,43,39,25,16,18,23,677658.0,16528.0,16616.0,16572.0,1562.3859914634147
New York Knicks,2010,42,40,23,18,19,22,799550.0,19501.0,17315.0,18408.0,1403.0687865853658
Philadelphia 76ers,2010,41,41,26,15,15,26,583219.0,14224.0,16889.0,15556.0,1425.4501817073171
Phoenix Suns,2010,40,42,23,18,17,24,723582.0,17648.0,17376.0,17512.0,1572.5799670731708
Utah Jazz,2010,39,43,21,20,18,23,794512.0,19378.0,17095.0,18237.0,1595.9572402439026
Indiana Pacers,2010,37,45,24,17,13,28,582295.0,14202.0,16955.0,15578.0,1427.3820414634147
Golden State Warriors,2010,36,46,26,15,10,31,739120.0,18027.0,16443.0,17235.0,1390.6618353658537
Milwaukee Bucks,2010,35,47,22,19,13,28,619453.0,15108.0,16823.0,15965.0,1494.0583268292683
Charlotte Hornets,2010,34,48,21,20,13,28,648790.0,15824.0,16256.0,16040.0,1515.628213414634
Los Angeles Clippers,2010,32,50,23,18,9,32,670063.0,16343.0,16225.0,16284.0,1365.9147414634147
Detroit Pistons,2010,30,52,21,20,9,32,768826.0,18751.0,17104.0,17928.0,1396.7273890243903
Brooklyn Nets,2010,24,58,19,22,5,36,537230.0,13103.0,16446.0,14774.0,1304.6722158536586
Sacramento Kings,2010,24,58,11,30,13,28,543416.0,13254.0,16973.0,15113.0,1348.9213902439026
Washington Wizards,2010,23,59,20,21,3,38,664398.0,16204.0,16487.0,16346.0,1368.7466853658536
Toronto Raptors,2010,22,60,16,25,6,35,733784.0,17897.0,16466.0,17181.0,1476.7681134146342
Cleveland Cavaliers,2010,19,63,12,29,7,34,843042.0,20562.0,19200.0,19881.0,1717.8986865853658
Minnesota Timberwolves,2010,17,65,12,29,5,36,619170.0,15101.0,16112.0,15607.0,1302.6781475609755
Chicago Bulls,2011,50,16,26,7,24,9,893462.0,21791.0,18431.0,20111.0,1601.8512207317071
San Antonio Spurs,2011,50,16,28,5,22,11,750879.0,18314.0,17389.0,17851.0,1665.9531231707317
Oklahoma City Thunder,2011,47,19,26,7,21,12,744068.0,18148.0,17774.0,17961.0,1587.8741817073171
Miami Heat,2011,46,20,28,5,18,15,810930.0,19778.0,19447.0,19612.0,1645.6149914634145
Indiana Pacers,2011,42,24,23,10,19,14,555077.0,13538.0,16844.0,15191.0,1482.3587987804879
Los Angeles Lakers,2011,41,25,26,7,15,18,778877.0,18997.0,19087.0,19042.0,1653.2202475609758
Memphis Grizzlies,2011,41,25,26,7,15,18,600687.0,14650.0,16441.0,15546.0,1518.5805743902438
Atlanta Hawks,2011,40,26,23,10,17,16,641596.0,15648.0,16957.0,16303.0,1544.8688036585365
Los Angeles Clippers,2011,40,26,24,9,16,17,727462.0,17742.0,17614.0,17678.0,1387.0146829268292
Boston Celtics,2011,39,27,24,9,15,18,763584.0,18624.0,18964.0,18794.0,1663.5553975609755
Denver Nuggets,2011,38,28,20,13,18,15,692968.0,16901.0,17285.0,17093.0,1585.4745853658537
Orlando Magic,2011,37,29,21,12,16,17,777852.0,18972.0,17428.0,18200.0,1645.3251341463413
Dallas Mavericks,2011,36,30,23,10,13,20,824162.0,20101.0,16657.0,18379.0,1621.3418963414633
New York Knicks,2011,36,30,22,11,14,19,808879.0,19728.0,18044.0,18886.0,1481.758756097561
Utah Jazz,2011,36,30,25,8,11,22,799982.0,19511.0,17331.0,18421.0,1530.2079999999999
Philadelphia 76ers,2011,35,31,19,14,16,17,604823.0,14751.0,17155.0,15953.0,1492.266343902439
Houston Rockets,2011,34,32,22,11,12,21,663839.0,16191.0,16943.0,16567.0,1514.9585560975609
Phoenix Suns,2011,33,33,19,14,14,19,720249.0,17567.0,17462.0,17514.0,1545.396268292683
Milwaukee Bucks,2011,31,35,17,16,14,19,631910.0,15412.0,16911.0,16162.0,1487.7518219512194
Portland Trail Blazers,2011,28,38,20,13,8,25,840924.0,20510.0,16333.0,18422.0,1543.5737402439024
Minnesota Timberwolves,2011,26,40,13,20,13,20,624960.0,15242.0,16885.0,16064.0,1314.6176073170732
Detroit Pistons,2011,25,41,18,15,7,26,683080.0,16660.0,16732.0,16696.0,1391.0489292682926
Golden State Warriors,2011,23,43,12,21,11,22,766398.0,18692.0,17049.0,17871.0,1431.6698609756097
Toronto Raptors,2011,23,43,13,20,10,23,679208.0,16566.0,16855.0,16710.0,1377.7312621951219
Brooklyn Nets,2011,22,44,9,24,13,20,581378.0,14179.0,17098.0,15639.0,1346.320213414634
Sacramento Kings,2011,22,44,16,17,6,27,569496.0,13890.0,17400.0,15645.0,1347.9094390243902
Cleveland Cavaliers,2011,21,45,11,22,10,23,824595.0,20112.0,16200.0,18156.0,1375.1612695121953
New Orleans Pelicans,2011,21,45,11,22,10,23,603088.0,14709.0,17179.0,15944.0,1530.022836585366
Washington Wizards,2011,20,46,11,22,9,24,688466.0,16791.0,17192.0,16992.0,1337.4226073170732
Charlotte Hornets,2011,7,59,4,29,3,30,649694.0,15846.0,16473.0,16159.0,1453.8954475609755
Miami Heat,2012,66,16,37,4,29,12,657855.0,19935.0,19399.0,19667.0,1680.059246969697
Oklahoma City Thunder,2012,60,22,34,7,26,15,600699.0,18203.0,18031.0,18117.0,1666.2710878787877
San Antonio Spurs,2012,58,24,35,6,23,18,607095.0,18396.0,16990.0,17693.0,1630.6627166666667
Denver Nuggets,2012,57,25,38,3,19,22,561966.0,17029.0,17228.0,17128.0,1580.371993939394
Los Angeles Clippers,2012,56,26,32,9,24,17,634237.0,19219.0,18342.0,18781.0,1531.9066893939394
Memphis Grizzlies,2012,56,26,32,9,24,17,518256.0,15704.0,17068.0,16386.0,1581.8584393939395
New York Knicks,2012,54,28,31,10,23,18,652179.0,19763.0,18407.0,19085.0,1502.5715409090908
Brooklyn Nets,2012,49,33,26,15,23,18,460719.0,13961.0,17081.0,15521.0,1343.0871424242423
Indiana Pacers,2012,49,32,30,11,19,21,467561.0,14168.0,16597.0,15382.0,1546.2637333333332
Golden State Warriors,2012,47,35,28,13,19,22,622311.0,18857.0,16364.0,17611.0,1453.5225772727272
Chicago Bulls,2012,45,37,24,17,21,20,731326.0,22161.0,17989.0,20075.0,1673.662609090909
Houston Rockets,2012,45,37,29,12,16,25,506994.0,15363.0,17733.0,16548.0,1528.0532666666666
Los Angeles Lakers,2012,45,37,29,12,16,25,626901.0,18997.0,19034.0,19015.0,1595.0698045454544
Atlanta Hawks,2012,44,38,25,16,19,22,501593.0,15199.0,16820.0,16010.0,1536.5703848484848
Utah Jazz,2012,43,39,30,11,13,28,637124.0,19306.0,16929.0,18118.0,1495.665162121212
Boston Celtics,2012,41,40,27,13,14,27,614592.0,18624.0,18288.0,18456.0,1558.7850030303032
Dallas Mavericks,2012,41,41,24,17,17,24,671050.0,20334.0,17712.0,19023.0,1594.5803166666667
Milwaukee Bucks,2012,38,44,21,20,17,24,485717.0,14718.0,16661.0,15689.0,1494.730459090909
Philadelphia 76ers,2012,34,48,23,18,11,30,577597.0,17502.0,16764.0,17133.0,1556.6878272727274
Toronto Raptors,2012,34,48,21,20,13,28,555584.0,16835.0,16732.0,16784.0,1368.272134848485
Portland Trail Blazers,2012,33,49,22,19,11,30,676384.0,20496.0,17164.0,18830.0,1521.5536590909092
Minnesota Timberwolves,2012,31,51,20,21,11,30,577197.0,17490.0,16310.0,16900.0,1428.964396969697
Detroit Pistons,2012,29,53,18,23,11,30,475638.0,14413.0,16342.0,15378.0,1380.9449727272727
Washington Wizards,2012,29,53,22,19,7,34,552038.0,16728.0,16361.0,16544.0,1331.5222742424244
Sacramento Kings,2012,28,54,20,21,8,33,478764.0,14508.0,16905.0,15706.0,1400.8652712121213
New Orleans Pelicans,2012,27,55,16,25,11,30,498618.0,15109.0,16717.0,15913.0,1419.2049166666666
Phoenix Suns,2012,25,57,17,24,8,33,514718.0,15597.0,17806.0,16702.0,1505.7803181818183
Cleveland Cavaliers,2012,24,58,14,27,10,31,525577.0,15926.0,16723.0,16324.0,1365.7331787878788
Charlotte Hornets,2012,21,61,15,26,6,35,486984.0,14757.0,16534.0,15645.0,1284.1820424242426
Orlando Magic,2012,20,62,12,29,8,33,623587.0,18896.0,17161.0,18028.0,1563.9305545454545
San Antonio Spurs,2013,62,20,32,9,30,11,755700.0,18431.0,17290.0,17861.0,1690.6813975609757
Oklahoma City Thunder,2013,59,23,34,7,25,16,746323.0,18203.0,18335.0,18269.0,1692.747692682927
Los Angeles Clippers,2013,57,25,34,7,23,18,788293.0,19226.0,17806.0,18516.0,1629.290724390244
Indiana Pacers,2013,56,26,35,6,21,20,626069.0,15269.0,17061.0,16154.0,1577.844975308642
Houston Rockets,2013,54,28,33,8,21,20,683564.0,16672.0,17982.0,17327.0,1558.3915951219512
Miami Heat,2013,54,28,32,9,22,19,819290.0,19982.0,19090.0,19536.0,1688.5625402439025
Portland Trail Blazers,2013,54,28,31,10,23,18,813012.0,19829.0,16727.0,18278.0,1459.2426048780487
Golden State Warriors,2013,51,31,27,14,24,17,794320.0,19373.0,17204.0,18288.0,1510.128748780488
Memphis Grizzlies,2013,50,32,27,14,23,18,681613.0,16624.0,17194.0,16909.0,1614.344162195122
Dallas Mavericks,2013,49,33,26,15,23,18,821490.0,20036.0,17613.0,18824.0,1494.8288231707318
Chicago Bulls,2013,48,34,27,14,21,20,896944.0,21876.0,18144.0,20010.0,1553.0837670731707
Toronto Raptors,2013,48,34,26,15,22,19,743936.0,18144.0,16313.0,17229.0,1434.183487804878
Phoenix Suns,2013,48,34,26,15,22,19,632913.0,15436.0,17152.0,16294.0,1433.06105
Brooklyn Nets,2013,44,38,28,13,16,25,704702.0,17187.0,17239.0,17213.0,1498.5548024390243
Washington Wizards,2013,44,38,22,19,22,19,670070.0,16343.0,16193.0,16268.0,1408.253530487805
Charlotte Hornets,2013,43,39,25,16,18,23,628293.0,15324.0,16502.0,15913.0,1260.2044426829268
Minnesota Timberwolves,2013,40,42,24,17,16,25,669956.0,16340.0,17034.0,16687.0,1435.8570707317074
Atlanta Hawks,2013,38,44,24,17,14,27,620146.0,15125.0,17165.0,16145.0,1528.1147365853658
New York Knicks,2013,37,45,19,22,18,23,780353.0,19033.0,18271.0,18652.0,1588.4151719512195
Denver Nuggets,2013,36,46,22,19,14,27,730616.0,17819.0,17401.0,17610.0,1619.0846926829267
New Orleans Pelicans,2013,34,48,22,19,12,29,565930.0,13803.0,17254.0,15528.0,1424.5746365853659
Cleveland Cavaliers,2013,33,49,19,22,14,27,663882.0,16192.0,16780.0,16486.0,1351.438756097561
Detroit Pistons,2013,29,53,17,24,12,29,606094.0,14782.0,16885.0,15834.0,1410.706443902439
Sacramento Kings,2013,28,54,17,24,11,30,563743.0,13749.0,17305.0,15527.0,1392.4726280487805
Los Angeles Lakers,2013,27,55,14,27,13,28,778877.0,18997.0,18866.0,18931.0,1534.9353109756098
Boston Celtics,2013,25,57,16,25,9,32,744960.0,18624.0,17768.0,18191.0,1531.5148851851852
Utah Jazz,2013,25,57,16,25,9,32,765915.0,18680.0,16769.0,17724.0,1518.3886012195123
Orlando Magic,2013,23,59,19,22,4,37,721414.0,17595.0,16821.0,17208.0,1357.1337707317075
Philadelphia 76ers,2013,19,63,10,31,9,32,685412.0,16717.0,17323.0,17020.0,1448.7797695121951
Milwaukee Bucks,2013,15,67,10,31,5,36,616469.0,15035.0,16919.0,15977.0,1484.0582402439024
Golden State Warriors,2014,67,15,39,2,28,13,803436.0,19596.0,17526.0,18561.0,1602.664751219512
Atlanta Hawks,2014,60,22,35,6,25,16,587927.0,14339.0,17274.0,15807.0,1480.1067280487805
Houston Rockets,2014,56,26,30,11,26,15,743082.0,18123.0,17427.0,17775.0,1612.1471402439024
Los Angeles Clippers,2014,56,26,30,11,26,15,787692.0,19212.0,17218.0,18215.0,1644.8126475609756
Memphis Grizzlies,2014,55,27,31,10,24,17,685458.0,16718.0,17269.0,16993.0,1567.835456097561
San Antonio Spurs,2014,55,27,33,8,22,19,755031.0,18415.0,17627.0,18021.0,1693.197956097561
Cleveland Cavaliers,2014,53,29,31,10,22,19,710522.0,17329.0,17388.0,17358.0,1387.1900085365855
Portland Trail Blazers,2014,51,31,32,9,19,22,809612.0,19746.0,17312.0,18529.0,1575.6281573170731
Chicago Bulls,2014,50,32,27,14,23,18,890370.0,21716.0,17551.0,19634.0,1525.2614426829268
Dallas Mavericks,2014,50,32,27,14,23,18,817982.0,19950.0,17268.0,18609.0,1558.7798597560975
Toronto Raptors,2014,49,33,27,14,22,19,748339.0,18252.0,16702.0,17477.0,1548.0947317073171
Washington Wizards,2014,46,36,29,12,17,24,698068.0,17026.0,17183.0,17104.0,1498.4840292682927
New Orleans Pelicans,2014,45,37,28,13,17,24,672029.0,16390.0,17397.0,16894.0,1444.298725609756
Oklahoma City Thunder,2014,45,37,29,12,16,25,746323.0,18203.0,18170.0,18186.0,1680.238173170732
Milwaukee Bucks,2014,41,41,23,18,18,23,552967.0,13487.0,17013.0,15250.0,1319.0984390243902
Boston Celtics,2014,40,42,21,20,19,22,742400.0,18107.0,17484.0,17796.0,1419.6202073170732
Phoenix Suns,2014,39,43,22,19,17,24,650739.0,15871.0,17250.0,16560.0,1513.4192817073172
Brooklyn Nets,2014,38,44,19,22,19,22,707331.0,17251.0,17528.0,17390.0,1499.7687024390243
Indiana Pacers,2014,38,44,23,18,15,26,717542.0,17501.0,17872.0,17686.0,1631.9299207317072
Utah Jazz,2014,38,44,21,20,17,24,745203.0,18175.0,17295.0,17735.0,1421.7087914634146
Miami Heat,2014,37,45,20,21,17,24,811036.0,19781.0,19190.0,19486.0,1675.1676451219512
Charlotte Hornets,2014,33,49,19,22,14,27,636268.0,15518.0,17026.0,16272.0,1432.2713536585366
Detroit Pistons,2014,32,50,18,23,14,27,615238.0,15005.0,17280.0,16143.0,1401.4150097560976
Denver Nuggets,2014,30,52,19,22,11,30,692898.0,16899.0,17211.0,17055.0,1514.0941134146342
Sacramento Kings,2014,29,53,18,23,11,30,667949.0,16291.0,16859.0,16575.0,1415.2395585365855
Orlando Magic,2014,25,57,13,28,12,29,666046.0,16245.0,16583.0,16414.0,1331.747269512195
Los Angeles Lakers,2014,21,61,12,29,9,32,771974.0,18828.0,17845.0,18337.0,1414.0110719512195
Philadelphia 76ers,2014,18,64,12,29,6,35,568632.0,13869.0,17441.0,15655.0,1312.8530731707317
New York Knicks,2014,17,65,10,31,7,34,812292.0,19812.0,17422.0,18617.0,1472.9329048780487
Minnesota Timberwolves,2014,16,66,9,32,7,34,597157.0,14564.0,17605.0,16085.0,1542.6098414634146
Golden State Warriors,2015,73,9,39,2,34,7,803436.0,19596.0,18312.0,18954.0,1708.8664109756096
San Antonio Spurs,2015,67,15,40,1,27,14,762855.0,18606.0,17972.0,18289.0,1672.3799841463415
Cleveland Cavaliers,2015,57,25,33,8,24,17,843042.0,20562.0,18915.0,19738.0,1544.0732646341464
Toronto Raptors,2015,56,26,32,9,24,17,809824.0,19751.0,17522.0,18637.0,1574.4157048780487
Oklahoma City Thunder,2015,55,27,32,9,23,18,746323.0,18203.0,17956.0,18079.0,1580.8519402439024
Los Angeles Clippers,2015,53,29,29,12,24,17,785892.0,19168.0,18079.0,18623.0,1648.4184439024389
Atlanta Hawks,2015,48,34,27,14,21,20,713909.0,17412.0,17582.0,17497.0,1609.4312963414634
Boston Celtics,2015,48,34,28,13,20,21,721350.0,17593.0,17741.0,17667.0,1420.1036975609757
Charlotte Hornets,2015,48,34,30,11,18,23,704886.0,17192.0,17654.0,17423.0,1453.9361426829269
Miami Heat,2015,48,34,28,13,20,21,808223.0,19712.0,17703.0,18708.0,1488.7093975609755
Indiana Pacers,2015,45,37,26,15,19,22,691434.0,16864.0,17892.0,17378.0,1478.1334256097562
Detroit Pistons,2015,44,38,26,15,18,23,625917.0,15266.0,17866.0,16566.0,1407.8583597560976
Portland Trail Blazers,2015,44,38,28,13,16,25,801733.0,19554.0,17657.0,18605.0,1620.2961073170732
Dallas Mavericks,2015,42,40,23,18,19,22,827702.0,20187.0,17653.0,18920.0,1600.7638670731706
Memphis Grizzlies,2015,42,40,26,15,16,25,710502.0,17329.0,18017.0,17673.0,1621.6717085365854
Chicago Bulls,2015,42,40,26,15,16,25,875091.0,21343.0,18404.0,19874.0,1567.3633463414635
Houston Rockets,2015,41,41,23,18,18,23,747412.0,18229.0,17969.0,18099.0,1618.3409097560975
Washington Wizards,2015,41,41,22,19,19,22,747796.0,18238.0,18253.0,18246.0,1537.4578926829267
Utah Jazz,2015,40,42,24,17,16,25,772059.0,18830.0,17135.0,17982.0,1448.4386609756098
Orlando Magic,2015,35,47,23,18,12,29,688194.0,16785.0,17585.0,17185.0,1339.426593902439
Denver Nuggets,2015,33,49,18,23,15,26,602707.0,14700.0,17437.0,16068.0,1447.915806097561
Milwaukee Bucks,2015,33,49,23,18,10,31,611226.0,14907.0,17180.0,16044.0,1455.1373695121952
Sacramento Kings,2015,33,49,18,23,15,26,680049.0,16586.0,17515.0,17050.0,1425.4173695121951
New York Knicks,2015,32,50,18,23,14,27,812292.0,19812.0,17462.0,18637.0,1352.5188146341463
New Orleans Pelicans,2015,30,52,21,20,9,32,683757.0,16677.0,17640.0,17158.0,1499.1598109756098
Minnesota Timberwolves,2015,29,53,14,27,15,26,595652.0,14528.0,18000.0,16264.0,1365.5956073170732
Phoenix Suns,2015,23,59,14,27,9,32,693862.0,16923.0,17586.0,17254.0,1540.2925524390243
Brooklyn Nets,2015,21,61,14,27,7,34,698529.0,17037.0,18039.0,17538.0,1468.873269512195
Los Angeles Lakers,2015,17,65,12,29,5,36,768244.0,18737.0,17875.0,18306.0,1372.5224914634146
Philadelphia 76ers,2015,10,72,7,34,3,38,571572.0,13940.0,17665.0,15802.0,1281.6219292682927
Golden State Warriors,2016,67,15,36,5,31,10,803436.0,19596.0,19134.0,19365.0,1800.9448494268295
San Antonio Spurs,2016,61,21,31,10,30,11,756445.0,18449.0,17938.0,18194.0,1746.2992549146343
Houston Rockets,2016,55,27,30,11,25,16,737244.0,17981.0,17740.0,17861.0,1529.2965332317071
Boston Celtics,2016,53,29,30,11,23,18,749076.0,18270.0,17439.0,17854.0,1560.6031351707315
Cleveland Cavaliers,2016,51,31,31,10,20,21,843042.0,20562.0,18910.0,19736.0,1660.6922844512194
Los Angeles Clippers,2016,51,31,29,12,22,19,786910.0,19192.0,17792.0,18492.0,1625.9277872804878
Toronto Raptors,2016,51,31,28,13,23,18,812863.0,19825.0,17162.0,18494.0,1583.4487448414634
Utah Jazz,2016,51,31,29,12,22,19,791489.0,19304.0,17378.0,18341.0,1525.9955225609756
Washington Wizards,2016,49,33,30,11,19,22,725426.0,17693.0,17787.0,17740.0,1493.028416926829
Oklahoma City Thunder,2016,47,35,28,13,19,22,746323.0,18203.0,18258.0,18230.0,1631.0391846341465
Atlanta Hawks,2016,43,39,23,18,20,21,690150.0,16832.0,17611.0,17222.0,1558.8269355853658
Memphis Grizzlies,2016,43,39,24,17,19,22,684603.0,16697.0,17589.0,17143.0,1524.4269427804877
Indiana Pacers,2016,42,40,29,12,13,28,690733.0,16847.0,17851.0,17349.0,1532.108249585366
Milwaukee Bucks,2016,42,40,23,18,19,22,621808.0,15166.0,17623.0,16394.0,1425.3245971585366
Chicago Bulls,2016,41,41,25,16,16,25,894659.0,21820.0,18156.0,19988.0,1515.5648274146342
Portland Trail Blazers,2016,41,41,25,16,16,25,794085.0,19367.0,17703.0,18535.0,1534.0434250121953
Miami Heat,2016,41,41,23,18,18,23,809350.0,19740.0,18044.0,18892.0,1517.6172728292684
Denver Nuggets,2016,40,42,22,19,18,23,577898.0,14095.0,17751.0,15923.0,1436.5749841341462
Detroit Pistons,2016,37,45,24,17,13,28,677138.0,16515.0,17814.0,17164.0,1509.5725564390243
Charlotte Hornets,2016,36,46,22,19,14,27,716894.0,17485.0,17784.0,17634.0,1507.1167954512196
New Orleans Pelicans,2016,34,48,21,20,13,28,688549.0,16793.0,17851.0,17322.0,1459.0547359756097
Dallas Mavericks,2016,33,49,21,20,12,29,825901.0,20143.0,17727.0,18935.0,1530.8678317073172
Sacramento Kings,2016,32,50,17,24,15,26,707526.0,17256.0,17355.0,17306.0,1441.5420972682925
Minnesota Timberwolves,2016,31,51,20,21,11,30,581178.0,14175.0,17831.0,16003.0,1364.5777256707318
New York Knicks,2016,31,51,19,22,12,29,812292.0,19812.0,18440.0,19126.0,1394.1587258780487
Orlando Magic,2016,29,53,16,25,13,28,719275.0,17543.0,17175.0,17359.0,1422.1147224512194
Philadelphia 76ers,2016,28,54,17,24,11,30,610121.0,14881.0,17491.0,16186.0,1247.4934638414634
Los Angeles Lakers,2016,26,56,17,24,9,32,778877.0,18997.0,19149.0,19073.0,1296.2671454634146
Phoenix Suns,2016,24,58,15,26,9,32,701405.0,17107.0,16881.0,16994.0,1393.6006380121953
Brooklyn Nets,2016,20,62,13,28,7,34,620142.0,15125.0,18106.0,16615.0,1365.7143712195123
Houston Rockets,2017,65,17,34,7,31,10,695903.0,16973.0,18140.0,17556.0,1610.6072679268293
Toronto Raptors,2017,59,23,34,7,25,16,813050.0,19830.0,17925.0,18878.0,1589.7963970487806
Golden State Warriors,2017,58,24,29,12,29,12,803436.0,19596.0,19015.0,19305.0,1744.9635507804878
Boston Celtics,2017,55,27,27,14,28,13,760690.0,18553.0,18313.0,18433.0,1571.984119597561
Philadelphia 76ers,2017,52,30,30,11,22,19,710557.0,17330.0,17209.0,17269.0,1332.761335804878
Cleveland Cavaliers,2017,50,32,29,12,21,20,843042.0,20562.0,19021.0,19791.0,1642.8497034634145
Portland Trail Blazers,2017,49,33,28,13,21,20,792029.0,19317.0,17555.0,18436.0,1520.2359272439026
Indiana Pacers,2017,48,34,27,14,21,20,684578.0,16697.0,17848.0,17272.0,1499.1602269512196
New Orleans Pelicans,2017,48,34,24,17,24,17,663099.0,16173.0,18062.0,17118.0,1418.9918585365854
Oklahoma City Thunder,2017,48,34,27,14,21,20,746323.0,18203.0,18373.0,18288.0,1595.662855012195
Utah Jazz,2017,48,34,28,13,20,21,806605.0,19673.0,17212.0,18442.0,1582.4146924512195
Minnesota Timberwolves,2017,47,35,30,11,17,24,607203.0,14809.0,18113.0,16461.0,1452.6340135243902
San Antonio Spurs,2017,47,35,33,8,14,27,755347.0,18423.0,18131.0,18277.0,1702.0278154512193
Denver Nuggets,2017,46,36,31,10,15,26,605585.0,14770.0,17420.0,16095.0,1479.0328516463414
Miami Heat,2017,44,38,26,15,18,23,805400.0,19643.0,17818.0,18731.0,1512.8743220487804
Milwaukee Bucks,2017,44,38,25,16,19,22,648952.0,15828.0,17928.0,16878.0,1478.5988195975608
Washington Wizards,2017,43,39,23,18,20,21,697107.0,17002.0,17949.0,17476.0,1541.6322112804878
Los Angeles Clippers,2017,42,40,22,19,20,21,782609.0,19088.0,17889.0,18488.0,1607.5720261707315
Detroit Pistons,2017,39,43,25,16,14,27,655141.0,15979.0,17699.0,16839.0,1490.3545002804879
Charlotte Hornets,2017,36,46,21,20,15,26,710643.0,17332.0,17563.0,17448.0,1518.4029901707318
Los Angeles Lakers,2017,35,47,20,21,15,26,776917.0,18949.0,18191.0,18570.0,1368.7400930609756
New York Knicks,2017,29,53,19,22,10,31,810741.0,19774.0,17927.0,18850.0,1419.4466591585365
Brooklyn Nets,2017,28,54,15,26,13,28,632608.0,15429.0,17755.0,16592.0,1311.320139195122
Chicago Bulls,2017,27,55,17,24,10,31,888882.0,21680.0,18033.0,19856.0,1489.3022312195121
Sacramento Kings,2017,27,55,14,27,13,28,721928.0,17608.0,17489.0,17548.0,1433.8111132682925
Orlando Magic,2017,25,57,17,24,8,33,727875.0,17753.0,17333.0,17543.0,1400.8627914390245
Atlanta Hawks,2017,24,58,16,25,8,33,654306.0,15958.0,17816.0,16887.0,1507.0666704756097
Dallas Mavericks,2017,24,58,15,26,9,32,811366.0,19789.0,17519.0,18654.0,1446.330945609756
Memphis Grizzlies,2017,22,60,16,25,6,35,677314.0,16519.0,17655.0,17087.0,1520.9981654390244
Phoenix Suns,2017,21,61,10,31,11,30,708639.0,17283.0,17618.0,17451.0,1362.035019195122
Milwaukee Bucks,2018,60,22,33,8,27,14,685303.0,16714.0,18380.0,17547.0,1510.797831682927
Toronto Raptors,2018,58,24,32,9,26,15,813431.0,19839.0,17673.0,18756.0,1642.212734487805
Golden State Warriors,2018,57,25,30,11,27,14,803436.0,19596.0,18884.0,19240.0,1714.604824804878
Denver Nuggets,2018,54,28,34,7,20,21,702796.0,17141.0,17871.0,17506.0,1542.202079402439
Houston Rockets,2018,53,29,31,10,22,19,716008.0,17900.0,18369.0,18137.0,1680.1627064512193
Portland Trail Blazers,2018,53,29,32,9,21,20,795328.0,19398.0,17556.0,18477.0,1557.7321707195122
Philadelphia 76ers,2018,51,31,31,10,20,21,833503.0,20329.0,18012.0,19185.0,1511.7025860487804
Utah Jazz,2018,50,32,29,12,21,20,734806.0,17922.0,17495.0,17708.0,1570.8502816097562
Boston Celtics,2018,49,33,28,13,21,20,744960.0,18624.0,18588.0,18606.0,1589.5322017560975
Oklahoma City Thunder,2018,49,33,27,14,22,19,746323.0,18203.0,18866.0,18534.0,1561.144022304878
Indiana Pacers,2018,48,34,29,12,19,22,658119.0,16051.0,17749.0,16889.0,1532.9529529756098
Los Angeles Clippers,2018,48,34,26,15,22,19,697812.0,17019.0,17735.0,17373.0,1544.4550097073172
San Antonio Spurs,2018,48,34,32,9,16,25,754562.0,18403.0,18427.0,18415.0,1591.173953390244
Brooklyn Nets,2018,42,40,23,18,19,22,622278.0,15556.0,17687.0,16622.0,1396.708400902439
Orlando Magic,2018,42,40,25,16,17,24,715728.0,17893.0,17651.0,17770.0,1383.097672109756
Detroit Pistons,2018,41,41,26,15,15,26,713945.0,17413.0,17959.0,17686.0,1476.7414972682927
Charlotte Hornets,2018,39,43,25,16,14,27,671404.0,16375.0,17623.0,16999.0,1474.753599
Miami Heat,2018,39,43,19,22,20,21,785250.0,19631.0,18177.0,18895.0,1517.2609190121952
Sacramento Kings,2018,39,43,24,17,15,26,649571.0,17555.0,17478.0,17515.0,1357.5641749390243
Los Angeles Lakers,2018,37,45,22,19,15,26,776327.0,18934.0,18655.0,18796.0,1429.7654415
Minnesota Timberwolves,2018,36,46,25,16,11,30,699308.0,17056.0,17850.0,17453.0,1537.534597792683
Dallas Mavericks,2018,33,49,24,17,9,32,811453.0,19791.0,17374.0,18597.0,1424.4854493902437
Memphis Grizzlies,2018,33,49,21,20,12,29,653863.0,15947.0,17348.0,16648.0,1407.0487816707316
New Orleans Pelicans,2018,33,49,19,22,14,27,673920.0,16437.0,17911.0,17174.0,1521.6102743536585
Washington Wizards,2018,32,50,22,19,10,31,718946.0,17973.0,17682.0,17826.0,1545.4716816829268
Atlanta Hawks,2018,29,53,17,24,12,29,590769.0,14409.0,17854.0,16088.0,1387.7251396219513
Chicago Bulls,2018,22,60,9,32,13,28,851824.0,20776.0,18030.0,19403.0,1415.4965727682927
Cleveland Cavaliers,2018,19,63,13,28,6,35,843042.0,20562.0,19071.0,19825.0,1575.767546695122
Phoenix Suns,2018,19,63,12,29,7,34,674655.0,16866.0,17610.0,17243.0,1330.6467687195122
New York Knicks,2018,17,65,9,32,8,33,792608.0,19331.0,18179.0,18762.0,1426.1390178292684
Milwaukee Bucks,2019,56,17,30,5,26,12,721692.0,17602.0,18185.0,17893.0,1653.7581347317073
Toronto Raptors,2019,53,19,26,10,27,9,812822.0,19824.0,18239.0,19032.0,1632.8109571585367
Los Angeles Lakers,2019,52,19,25,10,27,9,778877.0,18997.0,18862.0,18929.0,1493.7314556585366
Los Angeles Clippers,2019,49,23,27,9,22,14,710327.0,17325.0,17233.0,17279.0,1535.4262951219512
Boston Celtics,2019,48,24,26,10,22,14,763584.0,18624.0,18671.0,18647.0,1588.124429207317
Denver Nuggets,2019,46,27,26,11,20,16,756457.0,18450.0,17474.0,17962.0,1597.3872331707316
Indiana Pacers,2019,45,28,25,11,20,17,689310.0,16812.0,17957.0,17377.0,1583.4875797804877
Houston Rockets,2019,44,28,24,12,20,16,740392.0,18058.0,17921.0,17989.0,1613.3978240121953
Miami Heat,2019,44,29,29,7,15,22,805264.0,19640.0,18176.0,18908.0,1480.984375097561
Oklahoma City Thunder,2019,44,28,23,14,21,14,746323.0,18203.0,17866.0,18034.0,1593.610857902439
Utah Jazz,2019,44,28,23,12,21,16,750546.0,18306.0,17517.0,17911.0,1593.2613734146341
Dallas Mavericks,2019,43,32,20,18,23,14,820569.0,20013.0,18073.0,19043.0,1451.5087841707318
Philadelphia 76ers,2019,43,30,31,4,12,26,838092.0,20441.0,17895.0,19168.0,1596.9047565487804
Brooklyn Nets,2019,35,37,20,16,15,21,612597.0,14941.0,18085.0,16513.0,1464.1244963658537
Portland Trail Blazers,2019,35,39,21,15,14,24,799345.0,19496.0,17992.0,18753.0,1592.6596198414634
Memphis Grizzlies,2019,34,39,20,17,14,22,607564.0,15578.0,17579.0,16604.0,1427.5926208292683
Phoenix Suns,2019,34,39,17,22,17,17,627023.0,15293.0,17982.0,16638.0,1298.0940389634145
Orlando Magic,2019,33,40,18,17,15,23,720024.0,17561.0,17659.0,17610.0,1450.6626194390244
San Antonio Spurs,2019,32,39,19,15,13,24,750616.0,18307.0,17381.0,17844.0,1543.6960401219512
Sacramento Kings,2019,31,41,16,19,15,22,700975.0,17096.0,17199.0,17148.0,1462.3364218780487
New Orleans Pelicans,2019,30,42,15,21,15,21,656183.0,16004.0,17667.0,16835.0,1521.8247923902438
Washington Wizards,2019,25,47,16,20,9,27,716996.0,17487.0,17509.0,17498.0,1457.6158119268293
Charlotte Hornets,2019,23,42,10,21,13,21,676570.0,16501.0,17648.0,17074.0,1486.7516903048781
Chicago Bulls,2019,22,43,14,20,8,23,823475.0,20084.0,17822.0,18953.0,1327.994854317073
New York Knicks,2019,21,45,11,22,10,23,779087.0,19002.0,17566.0,18284.0,1323.295639695122
Atlanta Hawks,2019,20,47,14,20,6,27,628440.0,15327.0,17786.0,16557.0,1360.4770076463415
Detroit Pistons,2019,20,46,11,22,9,24,675963.0,16486.0,17819.0,17153.0,1487.4454116219513
Cleveland Cavaliers,2019,19,46,11,25,8,21,793337.0,19349.0,17632.0,18490.0,1365.4280904999998
Minnesota Timberwolves,2019,19,45,8,24,11,21,627543.0,15305.0,17641.0,16473.0,1508.7096391707316
Golden State Warriors,2019,15,50,8,26,7,24,803436.0,19596.0,18790.0,19193.0,1657.8574195487806
Utah Jazz,2020,52,20,31,5,21,15,567486.0,18306.0,17261.0,17767.0,1593.4901712777778
Phoenix Suns,2020,51,21,27,9,24,12,550633.0,15732.0,17660.0,16622.0,1426.5631319726028
Philadelphia 76ers,2020,49,23,29,7,20,16,639491.0,20628.0,17706.0,19122.0,1590.3065128630137
Brooklyn Nets,2020,48,24,28,8,20,16,524907.0,16403.0,17910.0,17157.0,1470.7638625
Denver Nuggets,2020,47,25,25,11,22,14,633153.0,19186.0,17163.0,18190.0,1599.2193979726028
Los Angeles Clippers,2020,47,25,26,10,21,15,610176.0,19068.0,17855.0,18461.0,1600.8786633055556
Milwaukee Bucks,2020,46,26,26,10,20,16,549036.0,17710.0,17892.0,17805.0,1723.5882933561643
Dallas Mavericks,2020,42,30,21,15,21,15,682096.0,20061.0,18249.0,19169.0,1561.7659627733333
Los Angeles Lakers,2020,42,30,21,15,21,15,588907.0,18997.0,18877.0,18936.0,1619.528673605634
Portland Trail Blazers,2020,42,30,20,16,22,14,608634.0,19633.0,17941.0,18748.0,1523.0217798133335
Atlanta Hawks,2020,41,31,25,11,16,20,545453.0,16042.0,17786.0,16901.0,1361.2837364626866
New York Knicks,2020,41,31,25,11,16,20,620789.0,18811.0,17767.0,18289.0,1314.5955611363638
Miami Heat,2020,40,32,21,15,19,17,629771.0,19680.0,18127.0,18891.0,1573.126763
Golden State Warriors,2020,39,33,25,11,14,22,614176.0,18064.0,17454.0,17773.0,1422.4097739076922
Memphis Grizzlies,2020,38,34,18,18,20,16,523297.0,15857.0,17508.0,16670.0,1466.6994563783785
Boston Celtics,2020,36,36,21,15,15,21,610864.0,19089.0,18409.0,18749.0,1633.6059741944443
Washington Wizards,2020,34,38,19,17,15,21,532702.0,16646.0,17587.0,17117.0,1406.2392845833333
Indiana Pacers,2020,34,38,13,23,21,15,529002.0,16531.0,17297.0,16914.0,1552.5651334931506
Charlotte Hornets,2020,33,39,18,18,15,21,478591.0,15438.0,17564.0,16550.0,1407.8776473230769
San Antonio Spurs,2020,33,39,14,22,19,17,550515.0,18350.0,17588.0,17951.0,1509.5482207042255
Chicago Bulls,2020,31,41,15,21,16,20,639352.0,18804.0,17767.0,18310.0,1372.3913757692308
New Orleans Pelicans,2020,31,41,18,18,13,23,528172.0,16505.0,18234.0,17369.0,1459.8565651527779
Sacramento Kings,2020,31,41,16,20,15,21,520663.0,16795.0,17739.0,17282.0,1460.271853611111
Toronto Raptors,2020,27,45,16,20,11,25,633456.0,19795.0,17789.0,18792.0,1670.4151672083333
Minnesota Timberwolves,2020,23,49,13,23,10,26,482112.0,15066.0,17463.0,16264.0,1427.73469809375
Cleveland Cavaliers,2020,22,50,13,23,9,27,623576.0,17816.0,18254.0,18014.0,1322.0644144769233
Oklahoma City Thunder,2020,22,50,10,26,12,24,600699.0,18203.0,17855.0,18034.0,1568.0269698472223
Orlando Magic,2020,21,51,11,25,10,26,529870.0,17092.0,17243.0,17171.0,1498.159581630137
Detroit Pistons,2020,20,52,13,23,7,29,509463.0,15438.0,17641.0,16539.0,1421.211653848485
Houston Rockets,2020,17,55,9,27,8,28,578458.0,18076.0,18072.0,18074.0,1622.1347768194444
Phoenix Suns,2021,64,18,32,9,32,9,104027.0,3715.0,2951.0,3397.0,1611.8879086250001
Memphis Grizzlies,2021,56,26,30,11,26,15,61449.0,2194.0,2928.0,2500.0,1540.794885756757
Golden State Warriors,2021,53,29,31,10,22,19,33457.0,3041.0,2873.0,2939.0,1473.2762382567566
Miami Heat,2021,53,29,29,12,24,17,0.0,0.0,3272.0,3108.0,1526.2715681666666
Dallas Mavericks,2021,52,30,29,12,23,18,94849.0,3648.0,2316.0,3140.0,1548.736805861111
Boston Celtics,2021,51,31,28,13,23,18,30067.0,2312.0,2781.0,2607.0,1557.715009260274
Milwaukee Bucks,2021,51,31,27,14,24,17,64780.0,2591.0,2644.0,2612.0,1618.067575847222
Philadelphia 76ers,2021,51,31,24,17,27,14,68583.0,3810.0,2693.0,3284.0,1592.3390785416666
Utah Jazz,2021,49,33,29,12,20,21,151300.0,4450.0,3104.0,4077.0,1649.2702002222222
Denver Nuggets,2021,48,34,23,18,25,16,54554.0,3636.0,2481.0,3023.0,1604.352919
Toronto Raptors,2021,48,34,24,17,24,17,26024.0,2365.0,2046.0,2152.0,1540.2865786666666
Chicago Bulls,2021,46,36,27,14,19,22,13655.0,3413.0,2343.0,2538.0,1435.8386840277778
Minnesota Timberwolves,2021,46,36,26,15,20,21,15774.0,1434.0,2307.0,1937.0,1346.1751472222222
Brooklyn Nets,2021,44,38,20,21,24,17,30491.0,1524.0,3005.0,2182.0,1565.7449893333333
Cleveland Cavaliers,2021,44,38,25,16,19,22,91476.0,2950.0,2616.0,2828.0,1363.5930750833331
Atlanta Hawks,2021,43,39,27,14,16,25,59288.0,2195.0,2786.0,2397.0,1488.9996654722222
Charlotte Hornets,2021,43,39,22,19,21,20,68255.0,3412.0,2475.0,2981.0,1466.2906534657534
Los Angeles Clippers,2021,42,40,25,16,17,24,13901.0,1737.0,2932.0,2590.0,1619.0943532361111
New York Knicks,2021,37,45,17,24,20,21,42131.0,1755.0,2803.0,2244.0,1488.3450193194444
New Orleans Pelicans,2021,36,46,19,22,17,24,93120.0,2586.0,2793.0,2662.0,1499.3380335694444
Washington Wizards,2021,35,47,21,20,14,27,21331.0,2666.0,2678.0,2675.0,1418.9265312567568
San Antonio Spurs,2021,34,48,16,25,18,23,61053.0,3052.0,3170.0,3111.0,1499.5852558630136
Los Angeles Lakers,2021,33,49,21,20,12,29,23313.0,2331.0,3015.0,2762.0,1626.5992642328767
Sacramento Kings,2021,30,52,16,25,14,27,0.0,0.0,3007.0,2660.0,1439.3665014166666
Portland Trail Blazers,2021,27,55,17,24,10,31,7756.0,1939.0,3420.0,3138.0,1520.9825180694445
Indiana Pacers,2021,25,57,16,25,9,32,0.0,0.0,3030.0,2840.0,1514.932184837838
Oklahoma City Thunder,2021,24,58,12,29,12,29,0.0,0.0,2463.0,2203.0,1402.0020928333333
Detroit Pistons,2021,23,59,13,28,10,31,14250.0,647.0,2946.0,1579.0,1387.78805475
Orlando Magic,2021,22,60,12,29,10,31,130712.0,3630.0,2954.0,3405.0,1388.3652556666666
Houston Rockets,2021,20,62,11,30,9,32,117009.0,3250.0,3282.0,3259.0,1405.8393944722222
Milwaukee Bucks,2022,58,24,32,9,26,15,715581.0,17453.0,17656.0,17555.0,1596.9416292682927
Boston Celtics,2022,57,25,32,9,25,16,766240.0,19156.0,17583.0,18360.0,1574.1577592439025
Philadelphia 76ers,2022,54,28,29,12,25,16,846867.0,20655.0,16589.0,18622.0,1594.4868186707317
Denver Nuggets,2022,53,29,34,7,19,22,695262.0,16957.0,16864.0,16911.0,1566.6713952073171
Cleveland Cavaliers,2022,51,31,31,10,20,21,758228.0,18493.0,17134.0,17813.0,1517.0070985833333
Memphis Grizzlies,2022,51,31,35,6,16,25,646785.0,15775.0,17740.0,16757.0,1578.2373011097561
Sacramento Kings,2022,48,34,23,18,25,16,577583.0,14439.0,16598.0,15532.0,1398.1636904390243
New York Knicks,2022,47,35,23,18,24,17,763484.0,18621.0,17722.0,18177.0,1497.6917691585365
Brooklyn Nets,2022,45,37,23,18,22,19,711539.0,17354.0,17456.0,17405.0,1544.6170625301206
Phoenix Suns,2022,45,37,28,13,17,24,679252.0,16567.0,17403.0,16979.0,1690.8895782439024
Golden State Warriors,2022,44,38,33,8,11,30,740624.0,18064.0,18111.0,18087.0,1622.7499756707318
Los Angeles Clippers,2022,44,38,23,18,21,20,694005.0,16926.0,16910.0,16918.0,1521.6993192261905
Miami Heat,2022,44,38,27,14,17,24,804761.0,19628.0,17294.0,18476.0,1588.3577262926829
Los Angeles Lakers,2022,43,39,23,18,20,21,764631.0,18649.0,18179.0,18414.0,1466.4145455853659
Minnesota Timberwolves,2022,42,40,22,19,20,21,657148.0,16028.0,16811.0,16419.0,1516.4265603373494
New Orleans Pelicans,2022,42,40,27,14,15,26,635941.0,15510.0,16727.0,16103.0,1471.5165540119046
Atlanta Hawks,2022,41,41,24,17,17,24,672742.0,16408.0,17073.0,16736.0,1531.8932632380952
Toronto Raptors,2022,41,41,27,14,14,27,547343.0,18873.0,17233.0,17913.0,1529.4100390487806
Chicago Bulls,2022,40,42,22,19,18,23,856148.0,20881.0,18198.0,19556.0,1529.7958517317072
Oklahoma City Thunder,2022,40,42,24,17,16,25,595112.0,14877.0,16638.0,15768.0,1325.1204212195123
Dallas Mavericks,2022,38,44,23,18,15,26,809315.0,19739.0,17092.0,18415.0,1565.2994011219512
Utah Jazz,2022,37,45,23,18,14,27,750546.0,18306.0,16898.0,17610.0,1627.9696033048779
Indiana Pacers,2022,35,47,20,21,15,26,588743.0,14359.0,16794.0,15577.0,1454.361303512195
Washington Wizards,2022,35,47,19,22,16,25,637215.0,15541.0,16939.0,16231.0,1459.2417779512195
Orlando Magic,2022,34,48,20,21,14,27,622881.0,15192.0,17062.0,16127.0,1317.3298178780487
Portland Trail Blazers,2022,33,49,17,24,16,25,705608.0,17209.0,16559.0,16888.0,1447.0783336585366
Charlotte Hornets,2022,27,55,13,28,14,27,700755.0,17091.0,17503.0,17294.0,1497.2482008192771
Houston Rockets,2022,22,60,14,27,8,33,638977.0,15584.0,16655.0,16120.0,1312.6018159390244
San Antonio Spurs,2022,22,60,14,27,8,33,615588.0,15014.0,16939.0,15965.0,1476.6534712409639
Detroit Pistons,2022,17,65,9,32,8,33,663556.0,16184.0,16752.0,16468.0,1333.763010195122
Boston Celtics,2023,64,18,37,4,27,14,766240.0,19156.0,18830.0,18991.0,1653.7604993658535
Denver Nuggets,2023,57,25,33,8,24,17,788635.0,19235.0,17628.0,18431.0,1575.0368153658537
Oklahoma City Thunder,2023,57,25,33,8,24,17,636903.0,15534.0,17948.0,16726.0,1465.3610218690476
Minnesota Timberwolves,2023,56,26,30,11,26,15,687510.0,16768.0,17499.0,17133.0,1511.483018952381
Los Angeles Clippers,2023,51,31,25,16,26,15,720543.0,17574.0,17625.0,17599.0,1504.7931547317073
Dallas Mavericks,2023,50,32,25,16,25,16,827282.0,20177.0,18138.0,19158.0,1538.5409607439024
New York Knicks,2023,50,32,27,14,23,18,795110.0,19392.0,18467.0,18930.0,1549.7685927439024
Milwaukee Bucks,2023,49,33,31,11,18,22,718786.0,17531.0,18296.0,17913.0,1599.563114487805
New Orleans Pelicans,2023,49,33,21,19,28,14,687691.0,16772.0,18021.0,17397.0,1545.5371317710842
Phoenix Suns,2023,49,33,25,16,24,17,682840.0,17071.0,18294.0,17690.0,1568.8550770487805
Cleveland Cavaliers,2023,48,34,26,15,22,19,777280.0,19432.0,18093.0,18754.0,1578.6690262439024
Indiana Pacers,2023,47,35,26,15,21,20,641562.0,15647.0,17900.0,16774.0,1437.8813964268293
Los Angeles Lakers,2023,47,35,28,14,19,21,763168.0,18613.0,18777.0,18695.0,1479.9394713614458
Orlando Magic,2023,47,35,29,12,18,23,728405.0,17765.0,18013.0,17888.0,1408.1684875243902
Philadelphia 76ers,2023,47,35,25,16,22,19,839261.0,20469.0,17910.0,19190.0,1598.5300319512196
Miami Heat,2023,46,36,22,19,24,17,807190.0,19687.0,18369.0,19028.0,1547.4852094285714
Golden State Warriors,2023,46,36,21,20,25,16,740624.0,18064.0,19772.0,18907.0,1571.9130478658537
Sacramento Kings,2023,46,36,24,17,22,19,715491.0,17451.0,17534.0,17492.0,1508.042812792683
Houston Rockets,2023,41,41,27,14,14,27,668865.0,16313.0,17677.0,16995.0,1320.3923123414634
Chicago Bulls,2023,39,43,20,21,19,22,841632.0,20527.0,18243.0,19385.0,1493.863854547619
Atlanta Hawks,2023,36,46,21,20,15,26,719787.0,17555.0,18053.0,17804.0,1517.720844433735
Brooklyn Nets,2023,32,50,20,21,12,29,724439.0,17669.0,18312.0,17990.0,1541.086745609756
Utah Jazz,2023,31,51,21,20,10,31,728240.0,18206.0,17881.0,18041.0,1508.5272321707318
Memphis Grizzlies,2023,27,55,9,32,18,23,707836.0,17264.0,18162.0,17713.0,1604.446217829268
Toronto Raptors,2023,25,57,14,27,11,30,811261.0,19786.0,17755.0,18771.0,1526.9972582530122
San Antonio Spurs,2023,22,60,12,29,10,31,694434.0,16937.0,17649.0,17293.0,1357.9643749512195
Charlotte Hornets,2023,21,61,11,30,10,31,702052.0,17123.0,18032.0,17578.0,1420.1636629390243
Portland Trail Blazers,2023,21,61,11,30,10,31,767374.0,18716.0,17786.0,18257.0,1415.1682325365855
Washington Wizards,2023,15,67,7,34,8,33,710481.0,17328.0,17753.0,17541.0,1468.3575819512196
Detroit Pistons,2023,14,68,7,33,7,35,759715.0,18529.0,17866.0,18197.0,1344.7894750243904
